1111111111111
1C010000C00C1
100C011111C01
1P0011E000001
1111111111111